............................
............................
...########.................
...#........................
...#........................
...#........................
...#........................
...#........................
...#........................
...#........................
............................
............................
........############........
............................
............................
........############........
............................
............................
........................#...
........................#...
......s.................#...
........................#...
........................#...
........................#...
........................#...
.................########...
............................
............................
4