..............................
..............................
..............................
..............................
....######################....
..............................
..............................
..............................
..............................
..............................
..............................
..............................
..............................
..............................
..............s...............
..............................
..............................
..............................
..............................
..............................
..............................
..............................
..............................
..............................
..............................
....######################....
..............................
..............................
..............................
..............................
5