............................
....###.....####.....###....
............................
............................
............................
............................
..###.....####.....###......
............................
............................
............................
............................
......###.....####.....###..
............................
............................
.................s..........
............................
....###.....####.....###....
............................
............................
............................
............................
..###.....####.....###......
............................
............................
............................
............................
......###.....####.....###..
............................
7